0 1 1 1 1 1 2 3 4 5 6 7 8 9 10 11 12 13 14 15 16 17 18 19 20 11 12 13 21 22 23 24 25 26 27 28 29 30 1 1 1 1 1 1 1 1 1 1 1 1 1 1 1 1 1 1 1 1 1 1 1 1 1 1 1 1 1 1 1 1 
0 1 1 1 1 31 32 33 34 35 36 37 38 39 40 41 42 43 44 45 46 47 48 49 50 41 42 43 51 52 53 54 25 55 56 57 58 59 30 1 1 1 1 1 1 1 1 1 1 1 1 1 1 1 1 1 1 1 1 1 1 1 1 1 1 1 1 1 1 60 
0 1 1 1 61 62 63 64 65 66 67 68 8 69 5 6 70 71 49 72 73 74 75 76 77 72 78 71 79 80 81 82 38 83 66 84 85 86 87 28 29 30 1 1 1 1 1 1 88 1 1 1 1 1 1 1 1 1 1 1 1 1 1 1 1 1 1 1 89 90 
0 1 1 2 91 92 93 94 95 41 42 96 38 97 35 98 99 66 84 100 101 102 103 104 84 100 105 66 106 107 108 109 110 111 112 113 114 115 116 86 117 59 30 1 1 1 1 1 88 61 118 1 1 1 1 1 1 1 1 1 1 1 1 1 1 1 1 119 120 121 
0 1 122 123 124 125 126 127 128 129 130 131 8 132 66 67 133 112 113 134 135 136 135 112 113 134 137 138 139 136 135 140 141 142 34 35 143 144 145 115 146 147 148 149 1 1 1 150 151 152 153 154 155 1 1 1 1 1 1 1 1 1 1 1 1 156 157 158 159 160 
161 62 63 162 163 164 165 166 167 168 169 170 38 171 41 42 172 34 35 173 174 175 176 177 178 179 107 108 180 181 182 183 8 184 65 66 185 186 187 188 189 190 191 192 30 1 61 193 194 195 196 197 198 1 1 199 200 201 202 203 204 1 1 1 1 205 206 207 201 1 
208 209 210 211 212 213 214 215 216 214 217 218 219 220 221 95 222 65 66 223 224 225 226 227 228 229 176 230 231 232 233 234 38 235 112 113 236 237 113 238 113 239 27 28 240 29 30 202 241 242 243 244 245 1 1 156 246 156 247 248 249 1 1 1 1 250 251 160 1 1 
252 253 254 255 256 257 258 259 260 258 261 262 263 264 265 266 267 95 41 268 269 270 271 272 273 176 274 275 276 277 278 279 25 280 34 35 281 282 283 284 285 286 287 288 58 289 290 291 292 293 294 295 296 297 118 1 1 1 1 1 1 1 1 1 156 298 299 1 1 1 
300 301 302 303 304 305 306 307 308 309 310 311 8 312 313 314 315 316 22 23 317 318 319 320 321 322 323 232 233 324 325 326 219 327 65 66 328 329 330 331 332 333 145 334 335 336 28 240 337 338 339 244 245 153 340 1 1 1 1 1 1 1 1 1 199 200 201 1 1 341 
342 343 344 345 346 347 348 349 350 351 93 352 353 354 355 258 261 356 52 53 357 358 359 360 361 362 363 364 365 366 367 368 369 370 371 372 373 374 233 375 376 35 281 377 378 56 57 58 379 122 380 381 382 383 384 1 1 1 1 1 1 1 156 385 386 387 1 202 388 389 
390 391 392 393 394 395 396 397 398 125 126 399 25 400 401 309 310 402 403 404 405 406 407 408 409 410 411 412 413 414 415 416 8 417 418 253 254 419 65 66 420 66 328 421 422 145 423 424 425 426 244 427 428 244 245 1 1 1 1 1 1 1 199 200 201 1 429 430 431 432 
433 434 435 1 1 1 31 436 437 438 439 440 441 442 443 444 445 446 447 448 449 450 451 452 453 454 455 456 457 458 459 460 461 462 463 301 302 464 371 465 466 66 467 468 469 470 471 189 472 473 474 475 476 295 296 477 1 1 1 1 199 200 201 202 478 1 479 480 481 482 
483 428 484 1 1 1 1 485 486 487 488 489 490 491 492 443 493 494 495 496 497 498 499 500 501 502 503 504 505 506 507 508 38 509 510 343 344 511 118 61 512 513 514 515 516 517 518 113 519 520 521 522 428 244 245 153 154 523 524 525 526 246 156 247 527 528 529 530 531 532 
533 534 535 536 1 1 1 1 537 538 539 540 541 542 543 544 545 546 547 548 549 550 551 285 552 553 554 555 556 557 558 559 110 560 561 391 392 562 1 1 61 563 564 65 66 565 566 567 568 569 570 571 572 573 574 575 576 577 578 579 580 1 581 582 156 583 584 585 586 587 
588 589 590 591 592 1 1 1 593 594 595 596 597 598 599 600 601 602 603 604 605 606 607 608 609 610 611 612 613 614 615 616 25 617 618 434 435 2 91 619 620 621 468 622 623 624 625 626 627 57 628 629 630 631 632 633 634 635 636 129 637 477 638 639 640 641 642 643 644 645 
646 647 648 649 650 527 1 1 651 652 653 654 655 656 657 658 659 660 661 662 663 664 665 666 667 668 669 670 671 672 670 673 38 674 675 543 676 562 2 91 677 678 679 680 681 682 360 683 684 115 685 686 687 688 689 57 58 690 691 692 693 694 695 696 697 698 643 699 700 701 
702 703 704 705 706 707 1 1 1 1 708 709 710 711 712 713 714 715 716 717 718 719 720 721 722 723 724 663 725 726 727 728 110 729 730 731 732 731 732 731 733 734 515 735 736 737 738 739 740 741 742 743 744 745 746 115 747 748 749 750 751 752 753 754 755 643 756 757 1 758 
759 760 761 762 763 764 201 1 1 1 765 766 767 768 769 770 771 772 773 774 610 611 775 776 777 778 779 780 781 782 783 784 25 785 734 515 786 787 788 789 790 791 792 793 794 795 796 797 798 799 800 801 802 803 804 471 189 805 806 609 610 807 808 611 809 611 809 611 810 613 
0 1 1 1 1 1 2 3 4 5 6 7 8 9 10 11 12 13 14 15 16 17 18 19 20 11 12 13 21 22 23 24 25 26 27 28 29 30 1 1 1 1 1 1 1 1 1 1 1 1 1 1 1 1 1 1 1 1 1 1 1 1 1 1 1 1 1 1 1 1 
0 1 1 1 1 31 32 33 34 35 36 37 38 39 40 41 42 43 44 45 46 47 48 49 50 41 42 43 51 52 53 54 25 55 56 57 58 59 30 1 1 1 1 1 1 1 1 1 1 1 1 1 1 1 1 1 1 1 1 1 1 1 1 1 1 1 1 1 1 60 
0 1 1 1 61 62 63 64 65 66 67 68 8 69 5 6 70 71 49 72 73 74 75 76 77 72 78 71 79 80 81 82 38 83 66 84 85 86 87 28 29 30 1 1 1 1 1 1 88 1 1 1 1 1 1 1 1 1 1 1 1 1 1 1 1 1 1 1 89 90 
0 1 1 2 91 92 93 94 95 41 42 96 38 97 35 98 99 66 84 100 101 102 103 104 84 100 105 66 106 107 108 109 110 111 112 113 114 115 116 86 117 59 30 1 1 1 1 1 88 61 118 1 1 1 1 1 1 1 1 1 1 1 1 1 1 1 1 119 120 121 
0 1 122 123 124 125 126 127 128 129 130 131 8 132 66 67 133 112 113 134 135 136 135 112 113 134 137 138 139 136 135 140 141 142 34 35 143 144 145 115 146 147 148 149 1 1 1 150 151 152 153 154 155 1 1 1 1 1 1 1 1 1 1 1 1 156 157 158 159 160 
161 62 63 162 163 164 165 166 167 168 169 170 38 171 41 42 172 34 35 173 174 175 176 177 178 179 107 108 180 181 182 183 8 184 65 66 185 186 187 188 189 190 191 192 30 1 61 193 194 195 196 197 198 1 1 199 200 201 202 203 204 1 1 1 1 205 206 207 201 1 
208 209 210 211 212 213 214 215 216 214 217 218 219 220 221 95 222 65 66 223 224 225 226 227 228 229 176 230 231 232 233 234 38 235 112 113 236 237 113 238 113 239 27 28 240 29 30 202 241 242 243 244 245 1 1 156 246 156 247 248 249 1 1 1 1 250 251 160 1 1 
252 253 254 255 256 257 258 259 260 258 261 262 263 264 265 266 267 95 41 268 269 270 271 272 273 176 274 275 276 277 278 279 25 280 34 35 281 282 283 284 285 286 287 288 58 289 290 291 292 293 294 295 296 297 118 1 1 1 1 1 1 1 1 1 156 298 299 1 1 1 
300 301 302 303 304 305 306 307 308 309 310 311 8 312 313 314 315 316 22 23 317 318 319 320 321 322 323 232 233 324 325 326 219 327 65 66 328 329 330 331 332 333 145 334 335 336 28 240 337 338 339 244 245 153 340 1 1 1 1 1 1 1 1 1 199 200 201 1 1 341 
342 343 344 345 346 347 348 349 350 351 93 352 353 354 355 258 261 356 52 53 357 358 359 360 361 362 363 364 365 366 367 368 369 370 371 372 373 374 233 375 376 35 281 377 378 56 57 58 379 122 380 381 382 383 384 1 1 1 1 1 1 1 156 385 386 387 1 202 388 389 
390 391 392 393 394 395 396 397 398 125 126 399 25 400 401 309 310 402 403 404 405 406 407 408 409 410 411 412 413 414 415 416 8 417 418 253 254 419 65 66 420 66 328 421 422 145 423 424 425 426 244 427 428 244 245 1 1 1 1 1 1 1 199 200 201 1 429 430 431 432 
433 434 435 1 1 1 31 436 437 438 439 440 441 442 443 444 445 446 447 448 449 450 451 452 453 454 455 456 457 458 459 460 461 462 463 301 302 464 371 465 466 66 467 468 469 470 471 189 472 473 474 475 476 295 296 477 1 1 1 1 199 200 201 202 478 1 479 480 481 482 
483 428 484 1 1 1 1 485 486 487 488 489 490 491 492 443 493 494 495 496 497 498 499 500 501 502 503 504 505 506 507 508 38 509 510 343 344 511 118 61 512 513 514 515 516 517 518 113 519 520 521 522 428 244 245 153 154 523 524 525 526 246 156 247 527 528 529 530 531 532 
533 534 535 536 1 1 1 1 537 538 539 540 541 542 543 544 545 546 547 548 549 550 551 285 552 553 554 555 556 557 558 559 110 560 561 391 392 562 1 1 61 563 564 65 66 565 566 567 568 569 570 571 572 573 574 575 576 577 578 579 580 1 581 582 156 583 584 585 586 587 
588 589 590 591 592 1 1 1 593 594 595 596 597 598 599 600 601 602 603 604 605 606 607 608 609 610 611 612 613 614 615 616 25 617 618 434 435 2 91 619 620 621 468 622 623 624 625 626 627 57 628 629 630 631 632 633 634 635 636 129 637 477 638 639 640 641 642 643 644 645 
646 647 648 649 650 527 1 1 651 652 653 654 655 656 657 658 659 660 661 662 663 664 665 666 667 668 669 670 671 672 670 673 38 674 675 543 676 562 2 91 677 678 679 680 681 682 360 683 684 115 685 686 687 688 689 57 58 690 691 692 693 694 695 696 697 698 643 699 700 701 
702 703 704 705 706 707 1 1 1 1 708 709 710 711 712 713 714 715 716 717 718 719 720 721 722 723 724 663 725 726 727 728 110 729 730 731 732 731 732 731 733 734 515 735 736 737 738 739 740 741 742 743 744 745 746 115 747 748 749 750 751 752 753 754 755 643 756 757 1 758 
759 760 761 762 763 764 201 1 1 1 765 766 767 768 769 770 771 772 773 774 610 611 775 776 777 778 779 780 781 782 783 784 25 785 734 515 786 787 788 789 790 791 792 793 794 795 796 797 798 799 800 801 802 803 804 471 189 805 806 609 610 807 808 611 809 611 809 611 810 613 
0 1 1 1 1 1 2 3 4 5 6 7 8 9 10 11 12 13 14 15 16 17 18 19 20 11 12 13 21 22 23 24 25 26 27 28 29 30 1 1 1 1 1 1 1 1 1 1 1 1 1 1 1 1 1 1 1 1 1 1 1 1 1 1 1 1 1 1 1 1 
0 1 1 1 1 31 32 33 34 35 36 37 38 39 40 41 42 43 44 45 46 47 48 49 50 41 42 43 51 52 53 54 25 55 56 57 58 59 30 1 1 1 1 1 1 1 1 1 1 1 1 1 1 1 1 1 1 1 1 1 1 1 1 1 1 1 1 1 1 60 
0 1 1 1 61 62 63 64 65 66 67 68 8 69 5 6 70 71 49 72 73 74 75 76 77 72 78 71 79 80 81 82 38 83 66 84 85 86 87 28 29 30 1 1 1 1 1 1 88 1 1 1 1 1 1 1 1 1 1 1 1 1 1 1 1 1 1 1 89 90 
0 1 1 2 91 92 93 94 95 41 42 96 38 97 35 98 99 66 84 100 101 102 103 104 84 100 105 66 106 107 108 109 110 111 112 113 114 115 116 86 117 59 30 1 1 1 1 1 88 61 118 1 1 1 1 1 1 1 1 1 1 1 1 1 1 1 1 119 120 121 
0 1 122 123 124 125 126 127 128 129 130 131 8 132 66 67 133 112 113 134 135 136 135 112 113 134 137 138 139 136 135 140 141 142 34 35 143 144 145 115 146 147 148 149 1 1 1 150 151 152 153 154 155 1 1 1 1 1 1 1 1 1 1 1 1 156 157 158 159 160 
161 62 63 162 163 164 165 166 167 168 169 170 38 171 41 42 172 34 35 173 174 175 176 177 178 179 107 108 180 181 182 183 8 184 65 66 185 186 187 188 189 190 191 192 30 1 61 193 194 195 196 197 198 1 1 199 200 201 202 203 204 1 1 1 1 205 206 207 201 1 
208 209 210 211 212 213 214 215 216 214 217 218 219 220 221 95 222 65 66 223 224 225 226 227 228 229 176 230 231 232 233 234 38 235 112 113 236 237 113 238 113 239 27 28 240 29 30 202 241 242 243 244 245 1 1 156 246 156 247 248 249 1 1 1 1 250 251 160 1 1 
252 253 254 255 256 257 258 259 260 258 261 262 263 264 265 266 267 95 41 268 269 270 271 272 273 176 274 275 276 277 278 279 25 280 34 35 281 282 283 284 285 286 287 288 58 289 290 291 292 293 294 295 296 297 118 1 1 1 1 1 1 1 1 1 156 298 299 1 1 1 
300 301 302 303 304 305 306 307 308 309 310 311 8 312 313 314 315 316 22 23 317 318 319 320 321 322 323 232 233 324 325 326 219 327 65 66 328 329 330 331 332 333 145 334 335 336 28 240 337 338 339 244 245 153 340 1 1 1 1 1 1 1 1 1 199 200 201 1 1 341 
342 343 344 345 346 347 348 349 350 351 93 352 353 354 355 258 261 356 52 53 357 358 359 360 361 362 363 364 365 366 367 368 369 370 371 372 373 374 233 375 376 35 281 377 378 56 57 58 379 122 380 381 382 383 384 1 1 1 1 1 1 1 156 385 386 387 1 202 388 389 
390 391 392 393 394 395 396 397 398 125 126 399 25 400 401 309 310 402 403 404 405 406 407 408 409 410 411 412 413 414 415 416 8 417 418 253 254 419 65 66 420 66 328 421 422 145 423 424 425 426 244 427 428 244 245 1 1 1 1 1 1 1 199 200 201 1 429 430 431 432 
433 434 435 1 1 1 31 436 437 438 439 440 441 442 443 444 445 446 447 448 449 450 451 452 453 454 455 456 457 458 459 460 461 462 463 301 302 464 371 465 466 66 467 468 469 470 471 189 472 473 474 475 476 295 296 477 1 1 1 1 199 200 201 202 478 1 479 480 481 482 
483 428 484 1 1 1 1 485 486 487 488 489 490 491 492 443 493 494 495 496 497 498 499 500 501 502 503 504 505 506 507 508 38 509 510 343 344 511 118 61 512 513 514 515 516 517 518 113 519 520 521 522 428 244 245 153 154 523 524 525 526 246 156 247 527 528 529 530 531 532 
533 534 535 536 1 1 1 1 537 538 539 540 541 542 543 544 545 546 547 548 549 550 551 285 552 553 554 555 556 557 558 559 110 560 561 391 392 562 1 1 61 563 564 65 66 565 566 567 568 569 570 571 572 573 574 575 576 577 578 579 580 1 581 582 156 583 584 585 586 587 
588 589 590 591 592 1 1 1 593 594 595 596 597 598 599 600 601 602 603 604 605 606 607 608 609 610 611 612 613 614 615 616 25 617 618 434 435 2 91 619 620 621 468 622 623 624 625 626 627 57 628 629 630 631 632 633 634 635 636 129 637 477 638 639 640 641 642 643 644 645 
646 647 648 649 650 527 1 1 651 652 653 654 655 656 657 658 659 660 661 662 663 664 665 666 667 668 669 670 671 672 670 673 38 674 675 543 676 562 2 91 677 678 679 680 681 682 360 683 684 115 685 686 687 688 689 57 58 690 691 692 693 694 695 696 697 698 643 699 700 701 
702 703 704 705 706 707 1 1 1 1 708 709 710 711 712 713 714 715 716 717 718 719 720 721 722 723 724 663 725 726 727 728 110 729 730 731 732 731 732 731 733 734 515 735 736 737 738 739 740 741 742 743 744 745 746 115 747 748 749 750 751 752 753 754 755 643 756 757 1 758 
759 760 761 762 763 764 201 1 1 1 765 766 767 768 769 770 771 772 773 774 610 611 775 776 777 778 779 780 781 782 783 784 25 785 734 515 786 787 788 789 790 791 792 793 794 795 796 797 798 799 800 801 802 803 804 471 189 805 806 609 610 807 808 611 809 611 809 611 810 613 
0 1 1 1 1 1 2 3 4 5 6 7 8 9 10 11 12 13 14 15 16 17 18 19 20 11 12 13 21 22 23 24 25 26 27 28 29 30 1 1 1 1 1 1 1 1 1 1 1 1 1 1 1 1 1 1 1 1 1 1 1 1 1 1 1 1 1 1 1 1 
0 1 1 1 1 31 32 33 34 35 36 37 38 39 40 41 42 43 44 45 46 47 48 49 50 41 42 43 51 52 53 54 25 55 56 57 58 59 30 1 1 1 1 1 1 1 1 1 1 1 1 1 1 1 1 1 1 1 1 1 1 1 1 1 1 1 1 1 1 60 
0 1 1 1 61 62 63 64 65 66 67 68 8 69 5 6 70 71 49 72 73 74 75 76 77 72 78 71 79 80 81 82 38 83 66 84 85 86 87 28 29 30 1 1 1 1 1 1 88 1 1 1 1 1 1 1 1 1 1 1 1 1 1 1 1 1 1 1 89 90 
0 1 1 2 91 92 93 94 95 41 42 96 38 97 35 98 99 66 84 100 101 102 103 104 84 100 105 66 106 107 108 109 110 111 112 113 114 115 116 86 117 59 30 1 1 1 1 1 88 61 118 1 1 1 1 1 1 1 1 1 1 1 1 1 1 1 1 119 120 121 
0 1 122 123 124 125 126 127 128 129 130 131 8 132 66 67 133 112 113 134 135 136 135 112 113 134 137 138 139 136 135 140 141 142 34 35 143 144 145 115 146 147 148 149 1 1 1 150 151 152 153 154 155 1 1 1 1 1 1 1 1 1 1 1 1 156 157 158 159 160 
161 62 63 162 163 164 165 166 167 168 169 170 38 171 41 42 172 34 35 173 174 175 176 177 178 179 107 108 180 181 182 183 8 184 65 66 185 186 187 188 189 190 191 192 30 1 61 193 194 195 196 197 198 1 1 199 200 201 202 203 204 1 1 1 1 205 206 207 201 1 
208 209 210 211 212 213 214 215 216 214 217 218 219 220 221 95 222 65 66 223 224 225 226 227 228 229 176 230 231 232 233 234 38 235 112 113 236 237 113 238 113 239 27 28 240 29 30 202 241 242 243 244 245 1 1 156 246 156 247 248 249 1 1 1 1 250 251 160 1 1 
252 253 254 255 256 257 258 259 260 258 261 262 263 264 265 266 267 95 41 268 269 270 271 272 273 176 274 275 276 277 278 279 25 280 34 35 281 282 283 284 285 286 287 288 58 289 290 291 292 293 294 295 296 297 118 1 1 1 1 1 1 1 1 1 156 298 299 1 1 1 
300 301 302 303 304 305 306 307 308 309 310 311 8 312 313 314 315 316 22 23 317 318 319 320 321 322 323 232 233 324 325 326 219 327 65 66 328 329 330 331 332 333 145 334 335 336 28 240 337 338 339 244 245 153 340 1 1 1 1 1 1 1 1 1 199 200 201 1 1 341 
342 343 344 345 346 347 348 349 350 351 93 352 353 354 355 258 261 356 52 53 357 358 359 360 361 362 363 364 365 366 367 368 369 370 371 372 373 374 233 375 376 35 281 377 378 56 57 58 379 122 380 381 382 383 384 1 1 1 1 1 1 1 156 385 386 387 1 202 388 389 
390 391 392 393 394 395 396 397 398 125 126 399 25 400 401 309 310 402 403 404 405 406 407 408 409 410 411 412 413 414 415 416 8 417 418 253 254 419 65 66 420 66 328 421 422 145 423 424 425 426 244 427 428 244 245 1 1 1 1 1 1 1 199 200 201 1 429 430 431 432 
433 434 435 1 1 1 31 436 437 438 439 440 441 442 443 444 445 446 447 448 449 450 451 452 453 454 455 456 457 458 459 460 461 462 463 301 302 464 371 465 466 66 467 468 469 470 471 189 472 473 474 475 476 295 296 477 1 1 1 1 199 200 201 202 478 1 479 480 481 482 
483 428 484 1 1 1 1 485 486 487 488 489 490 491 492 443 493 494 495 496 497 498 499 500 501 502 503 504 505 506 507 508 38 509 510 343 344 511 118 61 512 513 514 515 516 517 518 113 519 520 521 522 428 244 245 153 154 523 524 525 526 246 156 247 527 528 529 530 531 532 
533 534 535 536 1 1 1 1 537 538 539 540 541 542 543 544 545 546 547 548 549 550 551 285 552 553 554 555 556 557 558 559 110 560 561 391 392 562 1 1 61 563 564 65 66 565 566 567 568 569 570 571 572 573 574 575 576 577 578 579 580 1 581 582 156 583 584 585 586 587 
588 589 590 591 592 1 1 1 593 594 595 596 597 598 599 600 601 602 603 604 605 606 607 608 609 610 611 612 613 614 615 616 25 617 618 434 435 2 91 619 620 621 468 622 623 624 625 626 627 57 628 629 630 631 632 633 634 635 636 129 637 477 638 639 640 641 642 643 644 645 
646 647 648 649 650 527 1 1 651 652 653 654 655 656 657 658 659 660 661 662 663 664 665 666 667 668 669 670 671 672 670 673 38 674 675 543 676 562 2 91 677 678 679 680 681 682 360 683 684 115 685 686 687 688 689 57 58 690 691 692 693 694 695 696 697 698 643 699 700 701 
702 703 704 705 706 707 1 1 1 1 708 709 710 711 712 713 714 715 716 717 718 719 720 721 722 723 724 663 725 726 727 728 110 729 730 731 732 731 732 731 733 734 515 735 736 737 738 739 740 741 742 743 744 745 746 115 747 748 749 750 751 752 753 754 755 643 756 757 1 758 
759 760 761 762 763 764 201 1 1 1 765 766 767 768 769 770 771 772 773 774 610 611 775 776 777 778 779 780 781 782 783 784 25 785 734 515 786 787 788 789 790 791 792 793 794 795 796 797 798 799 800 801 802 803 804 471 189 805 806 609 610 807 808 611 809 611 809 611 810 613 
0 1 1 1 1 1 2 3 4 5 6 7 8 9 10 11 12 13 14 15 16 17 18 19 20 11 12 13 21 22 23 24 25 26 27 28 29 30 1 1 1 1 1 1 1 1 1 1 1 1 1 1 1 1 1 1 1 1 1 1 1 1 1 1 1 1 1 1 1 1 
0 1 1 1 1 31 32 33 34 35 36 37 38 39 40 41 42 43 44 45 46 47 48 49 50 41 42 43 51 52 53 54 25 55 56 57 58 59 30 1 1 1 1 1 1 1 1 1 1 1 1 1 1 1 1 1 1 1 1 1 1 1 1 1 1 1 1 1 1 60 
0 1 1 1 61 62 63 64 65 66 67 68 8 69 5 6 70 71 49 72 73 74 75 76 77 72 78 71 79 80 81 82 38 83 66 84 85 86 87 28 29 30 1 1 1 1 1 1 88 1 1 1 1 1 1 1 1 1 1 1 1 1 1 1 1 1 1 1 89 90 
0 1 1 2 91 92 93 94 95 41 42 96 38 97 35 98 99 66 84 100 101 102 103 104 84 100 105 66 106 107 108 109 110 111 112 113 114 115 116 86 117 59 30 1 1 1 1 1 88 61 118 1 1 1 1 1 1 1 1 1 1 1 1 1 1 1 1 119 120 121 
0 1 122 123 124 125 126 127 128 129 130 131 8 132 66 67 133 112 113 134 135 136 135 112 113 134 137 138 139 136 135 140 141 142 34 35 143 144 145 115 146 147 148 149 1 1 1 150 151 152 153 154 155 1 1 1 1 1 1 1 1 1 1 1 1 156 157 158 159 160 
161 62 63 162 163 164 165 166 167 168 169 170 38 171 41 42 172 34 35 173 174 175 176 177 178 179 107 108 180 181 182 183 8 184 65 66 185 186 187 188 189 190 191 192 30 1 61 193 194 195 196 197 198 1 1 199 200 201 202 203 204 1 1 1 1 205 206 207 201 1 
208 209 210 211 212 213 214 215 216 214 217 218 219 220 221 95 222 65 66 223 224 225 226 227 228 229 176 230 231 232 233 234 38 235 112 113 236 237 113 238 113 239 27 28 240 29 30 202 241 242 243 244 245 1 1 156 246 156 247 248 249 1 1 1 1 250 251 160 1 1 
252 253 254 255 256 257 258 259 260 258 261 262 263 264 265 266 267 95 41 268 269 270 271 272 273 176 274 275 276 277 278 279 25 280 34 35 281 282 283 284 285 286 287 288 58 289 290 291 292 293 294 295 296 297 118 1 1 1 1 1 1 1 1 1 156 298 299 1 1 1 
300 301 302 303 304 305 306 307 308 309 310 311 8 312 313 314 315 316 22 23 317 318 319 320 321 322 323 232 233 324 325 326 219 327 65 66 328 329 330 331 332 333 145 334 335 336 28 240 337 338 339 244 245 153 340 1 1 1 1 1 1 1 1 1 199 200 201 1 1 341 
342 343 344 345 346 347 348 349 350 351 93 352 353 354 355 258 261 356 52 53 357 358 359 360 361 362 363 364 365 366 367 368 369 370 371 372 373 374 233 375 376 35 281 377 378 56 57 58 379 122 380 381 382 383 384 1 1 1 1 1 1 1 156 385 386 387 1 202 388 389 
390 391 392 393 394 395 396 397 398 125 126 399 25 400 401 309 310 402 403 404 405 406 407 408 409 410 411 412 413 414 415 416 8 417 418 253 254 419 65 66 420 66 328 421 422 145 423 424 425 426 244 427 428 244 245 1 1 1 1 1 1 1 199 200 201 1 429 430 431 432 
433 434 435 1 1 1 31 436 437 438 439 440 441 442 443 444 445 446 447 448 449 450 451 452 453 454 455 456 457 458 459 460 461 462 463 301 302 464 371 465 466 66 467 468 469 470 471 189 472 473 474 475 476 295 296 477 1 1 1 1 199 200 201 202 478 1 479 480 481 482 
483 428 484 1 1 1 1 485 486 487 488 489 490 491 492 443 493 494 495 496 497 498 499 500 501 502 503 504 505 506 507 508 38 509 510 343 344 511 118 61 512 513 514 515 516 517 518 113 519 520 521 522 428 244 245 153 154 523 524 525 526 246 156 247 527 528 529 530 531 532 
533 534 535 536 1 1 1 1 537 538 539 540 541 542 543 544 545 546 547 548 549 550 551 285 552 553 554 555 556 557 558 559 110 560 561 391 392 562 1 1 61 563 564 65 66 565 566 567 568 569 570 571 572 573 574 575 576 577 578 579 580 1 581 582 156 583 584 585 586 587 
588 589 590 591 592 1 1 1 593 594 595 596 597 598 599 600 601 602 603 604 605 606 607 608 609 610 611 612 613 614 615 616 25 617 618 434 435 2 91 619 620 621 468 622 623 624 625 626 627 57 628 629 630 631 632 633 634 635 636 129 637 477 638 639 640 641 642 643 644 645 
646 647 648 649 650 527 1 1 651 652 653 654 655 656 657 658 659 660 661 662 663 664 665 666 667 668 669 670 671 672 670 673 38 674 675 543 676 562 2 91 677 678 679 680 681 682 360 683 684 115 685 686 687 688 689 57 58 690 691 692 693 694 695 696 697 698 643 699 700 701 
702 703 704 705 706 707 1 1 1 1 708 709 710 711 712 713 714 715 716 717 718 719 720 721 722 723 724 663 725 726 727 728 110 729 730 731 732 731 732 731 733 734 515 735 736 737 738 739 740 741 742 743 744 745 746 115 747 748 749 750 751 752 753 754 755 643 756 757 1 758 
759 760 761 762 763 764 201 1 1 1 765 766 767 768 769 770 771 772 773 774 610 611 775 776 777 778 779 780 781 782 783 784 25 785 734 515 786 787 788 789 790 791 792 793 794 795 796 797 798 799 800 801 802 803 804 471 189 805 806 609 610 807 808 611 809 611 809 611 810 613 
0 1 1 1 1 1 2 3 4 5 6 7 8 9 10 11 12 13 14 15 16 17 18 19 20 11 12 13 21 22 23 24 25 26 27 28 29 30 1 1 1 1 1 1 1 1 1 1 1 1 1 1 1 1 1 1 1 1 1 1 1 1 1 1 1 1 1 1 1 1 
0 1 1 1 1 31 32 33 34 35 36 37 38 39 40 41 42 43 44 45 46 47 48 49 50 41 42 43 51 52 53 54 25 55 56 57 58 59 30 1 1 1 1 1 1 1 1 1 1 1 1 1 1 1 1 1 1 1 1 1 1 1 1 1 1 1 1 1 1 60 
0 1 1 1 61 62 63 64 65 66 67 68 8 69 5 6 70 71 49 72 73 74 75 76 77 72 78 71 79 80 81 82 38 83 66 84 85 86 87 28 29 30 1 1 1 1 1 1 88 1 1 1 1 1 1 1 1 1 1 1 1 1 1 1 1 1 1 1 89 90 
0 1 1 2 91 92 93 94 95 41 42 96 38 97 35 98 99 66 84 100 101 102 103 104 84 100 105 66 106 107 108 109 110 111 112 113 114 115 116 86 117 59 30 1 1 1 1 1 88 61 118 1 1 1 1 1 1 1 1 1 1 1 1 1 1 1 1 119 120 121 
0 1 122 123 124 125 126 127 128 129 130 131 8 132 66 67 133 112 113 134 135 136 135 112 113 134 137 138 139 136 135 140 141 142 34 35 143 144 145 115 146 147 148 149 1 1 1 150 151 152 153 154 155 1 1 1 1 1 1 1 1 1 1 1 1 156 157 158 159 160 
161 62 63 162 163 164 165 166 167 168 169 170 38 171 41 42 172 34 35 173 174 175 176 177 178 179 107 108 180 181 182 183 8 184 65 66 185 186 187 188 189 190 191 192 30 1 61 193 194 195 196 197 198 1 1 199 200 201 202 203 204 1 1 1 1 205 206 207 201 1 
208 209 210 211 212 213 214 215 216 214 217 218 219 220 221 95 222 65 66 223 224 225 226 227 228 229 176 230 231 232 233 234 38 235 112 113 236 237 113 238 113 239 27 28 240 29 30 202 241 242 243 244 245 1 1 156 246 156 247 248 249 1 1 1 1 250 251 160 1 1 
252 253 254 255 256 257 258 259 260 258 261 262 263 264 265 266 267 95 41 268 269 270 271 272 273 176 274 275 276 277 278 279 25 280 34 35 281 282 283 284 285 286 287 288 58 289 290 291 292 293 294 295 296 297 118 1 1 1 1 1 1 1 1 1 156 298 299 1 1 1 
300 301 302 303 304 305 306 307 308 309 310 311 8 312 313 314 315 316 22 23 317 318 319 320 321 322 323 232 233 324 325 326 219 327 65 66 328 329 330 331 332 333 145 334 335 336 28 240 337 338 339 244 245 153 340 1 1 1 1 1 1 1 1 1 199 200 201 1 1 341 
342 343 344 345 346 347 348 349 350 351 93 352 353 354 355 258 261 356 52 53 357 358 359 360 361 362 363 364 365 366 367 368 369 370 371 372 373 374 233 375 376 35 281 377 378 56 57 58 379 122 380 381 382 383 384 1 1 1 1 1 1 1 156 385 386 387 1 202 388 389 
390 391 392 393 394 395 396 397 398 125 126 399 25 400 401 309 310 402 403 404 405 406 407 408 409 410 411 412 413 414 415 416 8 417 418 253 254 419 65 66 420 66 328 421 422 145 423 424 425 426 244 427 428 244 245 1 1 1 1 1 1 1 199 200 201 1 429 430 431 432 
433 434 435 1 1 1 31 436 437 438 439 440 441 442 443 444 445 446 447 448 449 450 451 452 453 454 455 456 457 458 459 460 461 462 463 301 302 464 371 465 466 66 467 468 469 470 471 189 472 473 474 475 476 295 296 477 1 1 1 1 199 200 201 202 478 1 479 480 481 482 
483 428 484 1 1 1 1 485 486 487 488 489 490 491 492 443 493 494 495 496 497 498 499 500 501 502 503 504 505 506 507 508 38 509 510 343 344 511 118 61 512 513 514 515 516 517 518 113 519 520 521 522 428 244 245 153 154 523 524 525 526 246 156 247 527 528 529 530 531 532 
533 534 535 536 1 1 1 1 537 538 539 540 541 542 543 544 545 546 547 548 549 550 551 285 552 553 554 555 556 557 558 559 110 560 561 391 392 562 1 1 61 563 564 65 66 565 566 567 568 569 570 571 572 573 574 575 576 577 578 579 580 1 581 582 156 583 584 585 586 587 
588 589 590 591 592 1 1 1 593 594 595 596 597 598 599 600 601 602 603 604 605 606 607 608 609 610 611 612 613 614 615 616 25 617 618 434 435 2 91 619 620 621 468 622 623 624 625 626 627 57 628 629 630 631 632 633 634 635 636 129 637 477 638 639 640 641 642 643 644 645 
646 647 648 649 650 527 1 1 651 652 653 654 655 656 657 658 659 660 661 662 663 664 665 666 667 668 669 670 671 672 670 673 38 674 675 543 676 562 2 91 677 678 679 680 681 682 360 683 684 115 685 686 687 688 689 57 58 690 691 692 693 694 695 696 697 698 643 699 700 701 
702 703 704 705 706 707 1 1 1 1 708 709 710 711 712 713 714 715 716 717 718 719 720 721 722 723 724 663 725 726 727 728 110 729 730 731 732 731 732 731 733 734 515 735 736 737 738 739 740 741 742 743 744 745 746 115 747 748 749 750 751 752 753 754 755 643 756 757 1 758 
759 760 761 762 763 764 201 1 1 1 765 766 767 768 769 770 771 772 773 774 610 611 775 776 777 778 779 780 781 782 783 784 25 785 734 515 786 787 788 789 790 791 792 793 794 795 796 797 798 799 800 801 802 803 804 471 189 805 806 609 610 807 808 611 809 611 809 611 810 613 
